date,count,uniques
2026-01-10,0,0
2026-01-20,0,0
2026-01-27,0,0
2026-01-30,0,0
2026-02-09,0,0
2026-02-10,0,0
2026-02-28,1,1
2026-03-01,0,0
2026-03-02,0,0
2026-03-03,0,0
2026-03-05,0,0
