date,count,uniques
2026-01-10,0,0
2026-01-20,0,0
2026-01-27,0,0
2026-01-30,0,0
2026-02-09,0,0
2026-02-10,0,0
