date,ref_1,ref_1_count,ref_1_uniques,ref_2,ref_2_count,ref_2_uniques,ref_3,ref_3_count,ref_3_uniques,ref_4,ref_4_count,ref_4_uniques,ref_5,ref_5_count,ref_5_uniques,ref_6,ref_6_count,ref_6_uniques,ref_7,ref_7_count,ref_7_uniques,ref_8,ref_8_count,ref_8_uniques,ref_9,ref_9_count,ref_9_uniques,ref_10,ref_10_count,ref_10_uniques
2025-03-25,Bing,1,1,,,,,,,,,,,,,,,,,,,,,,,,,,,
2025-03-26,Bing,1,1,,,,,,,,,,,,,,,,,,,,,,,,,,,
2025-03-27,Bing,1,1,,,,,,,,,,,,,,,,,,,,,,,,,,,
2025-03-28,Bing,1,1,,,,,,,,,,,,,,,,,,,,,,,,,,,
2025-03-29,Bing,1,1,,,,,,,,,,,,,,,,,,,,,,,,,,,
2025-03-30,Bing,1,1,,,,,,,,,,,,,,,,,,,,,,,,,,,
2025-03-31,Bing,1,1,,,,,,,,,,,,,,,,,,,,,,,,,,,
2025-04-01,Bing,1,1,,,,,,,,,,,,,,,,,,,,,,,,,,,
2025-04-02,Bing,1,1,,,,,,,,,,,,,,,,,,,,,,,,,,,
2025-04-03,Bing,1,1,,,,,,,,,,,,,,,,,,,,,,,,,,,
2025-04-04,Bing,1,1,,,,,,,,,,,,,,,,,,,,,,,,,,,
